10
230 200 145 43 239 1,4
400 400 145 43 239 2,6,7
350 300 145 43 239 3,5,6
500 200 145 43 239 4,7,8
450 500 145 43 239 5,2,3
300 500 145 43 239 6,4,2
420 300 145 43 239 7,8
500 200 145 43 239 8,3,4
320 400 145 43 239 9,2,3
460 200 145 43 239 0,2,3
80 43 240
-2.7