10
230 200 65 206 93 1,4
400 400 65 206 93 2,6,7
350 300 65 206 93 3,5,6
500 200 65 206 93 4,7,8
450 500 65 206 93 5,2,3
300 500 65 206 93 6,4,2
420 300 65 206 93 7,8
500 200 65 206 93 8,3,4
320 400 65 206 93 9,2,3
460 200 65 206 93 0,2,3
120 0 0
-2.7